凯旋 - Triumph
归时 - Time of Return
走马 - Galloping Horse
醉月 - Drunken Moon
醒狮 - Awakened Lion
狂欢 - Carnival
骜涛 - Majestic Waves
怀念 - Remembrance
怀旧 - Nostalgia
悲秋 - Sad Autumn
西江月 - Moon Over the West River
月圆曲 - Moonlit Melody
小桃红 - Little Pink Peach
醉桃源 - Drunken Peach Blossom Land
鸟惊喧 - Startled Birds Chatter
鸟投林 - Birds Flock to the Woods
岐山凰 - Phoenix of Qishan
凤凰台 - Phoenix Terrace
花间蝶 - Butterflies Among Flowers
落花天 - Fallen Flowers in the Sky
早天雷 - Early Morning Thunder
到春雷 - Thunder Upon Spring


锦春城 - "Jin Chun Cheng" - Spring City
减春衣 - "Jian Chun Yi" - Reducing Spring Clothes
喜洋洋 - "Xi Yang Yang" - Joyful and Radiant
杨翠喜 - "Yang Cui Xi" - Cui Xi, the Willow
红烛泪 - "Hong Zhu Lei" - Tears of Red Candle
丝丝泪 - "Si Si Lei" - Silken Tears
一枝梅 - "Yi Zhi Mei" - Lone Plum Blossom
三叠愁 - "San Die Chou" - Triple-Layered Sorrow
三叠佛 - "San Die Fo" - Triple-Layered Buddha
放战忙 -  "Fang Zhan Mang" - Busy with War
白头吟 -  "Bai Tou Yin" - White-haired Lament
夜思郎 -  "Ye Si Lang" - Night Thoughts of a Gentleman
夜深沉 -  "Ye Shen Chen" - Night Deepens and Grows Silent
得胜令 -  "De Sheng Ling" - Victory Command
凌波令 -  "Ling Bo Ling" - Command on the Wavy Waves
下渔舟 -  "Xia Yu Zhou" - Descending Fishing Boat
下山虎 -  "Xia Shan Hu" - Descending Mountain Tiger
步步高 -  "Bu Bu Gao" - Step by Step Ascending
别鹤怨 -  "Bie He Yuan" - Crane's Lament
雪中燕 -  "Xue Zhong Yan" - Swallow in the Snow
聚中慢 -  "Ju Zhong Man" - Slow Dance in the Center
连环扣 -  "Lian Huan Kou" - Linked Buttoning


双耳恨 - Double Ear Hatred
昭君怨 - Zhaojun's Resentment
育破阵 - Breaking the Formation
银河会 - Meeting the Milky Way
银塘吐绝 - Silver Pond Desolation
梅林吐绝 - Plum Forest Desolation
禅院钟声 - Monastery Bell Chimes
孔雀开屏 - Peacock Unfolding
饿马摇铃 - Hungry Horse Bell Swing
青梅竹马 - Childhood Sweethearts
月影寒梅 - Moonlight and Cold Plum Blossoms
彩云追月 - Chasing the Colorful Clouds for the Moon
汉宫秋月 - Autumn Moon in the Han Palace
妆台秋思 - Autumn Thoughts at the Dressing Table
秋水龙吟 - Autumn Water Dragon Roar
平湖秋月 - Autumn Moon Over the Calm Lake
娱乐生平 - Entertainment Throughout Life
晚霞锦 - Evening Glow Brocade
渔歌晚唱 - Evening Singing of Fishermen
雪底游魂 - Wandering Soul in the Snow
流水行云 - Flowing Water and Moving Clouds
鱼游春水 - Fish Swimming in Spring Water
春到田间 - Spring in the Fields


春郊试马 - Spring Outing to Test Horses
春风得意 - Spring Breeze Brings Success
南岛春光 - Southern Island Spring Scenery
满园春色 - Garden in Full Spring Colors
陌头柳色 - Willow Colors Along the Lane
柳浪声鹰 - Willow Waves Echo with Eagles
柳娘三醉 - Willow Maiden Three Times Drunk
沉醉东风 - Intoxicated by the East Wind
赛龙夺锦 - Racing Dragons for Brocade
龙飞凤舞 - Dragons Soaring, Phoenixes Dancing
蕉石鸣琴 - Banana Stones Ringing the Qin
雨打芭蕉 - Rain Striking Banana Leaves
蕉窗夜雨 - Banana Window in Night Rain
寒山夜雨 - Cold Mountain Night Rain
满鸭穿莲 - Ducks Swimming Through Lotus
百尺竿头 - At the Top of a Hundred-Foot Pole
花香观马蹄 - Fragrant Flowers Watching Horse Hooves
胡茄十八拍 - Eighteen Beats of Huqin
午夜遥闻战马声 - Midnight Distant Battle Horses Heard
塞外风声逐马蹄 - Beyond the Great Wall, the Wind Follows Horse Hooves


